++++++++++++++++
++ +++++++++++++
+ AA+++++++++++
+A0A          a+
+ AA+++++++++++
++ +++++++++++++
++++++++++++++++
