+++++++++++++
+A A A A A A+
+ A A A A Aa+
+ A0A A A A +
+A A A A A A+
+++++++++++++
