+++++++++++++++++++++++++++++++++++++++++++++++
+                                             +
+                                             +
+                                             +
+                                             +
+                                             +
+                                             +
+                                             +
+                                             +
+                                             +
+                                             +
+                                             +
+              0    A  a                      +
+                                             +
+                                             +
+                                             +
+                                             +
+                                             +
+                                             +
+                                             +
+                                             +
+                                             +
+                                             +
+                                             +
+++++++++++++++++++++++++++++++++++++++++++++++
